xxxxxxxxxxx...xxxxxxxxxxx
x.......................x
x.......................x
x..0000...........0000..x
x..0000...........0000..x
x..0000...........0000..x
x.......................x
.........................
.........................
.........................
.........................
x.......................x
x..0000...........0000..x
x..0000...........0000..x
x..0000...........0000..x
x.......................x
x.......................x
xxxxxxxxxxx...xxxxxxxxxxx
