xxxxxxxxxxx...xxxxxxxxxxx
x.......................x
x.......................x
x.......................x
x......00.......00......x
x........0.....0........x
x.........0...0.........x
...........0.0...........
............0............
............0............
...........0.0...........
x.........0...0.........x
x........0.....0........x
x......00.......00......x
x.......................x
x.......................x
x.......................x
xxxxxxxxxxx...xxxxxxxxxxx
