xxxxxxxxxxx...xxxxxxxxxxx
x.......................x
x.......................x
x.......................x
x.......................x
x.......................x
x.......................x
............0............
...........000...........
............0............
.........................
x.......................x
x.......................x
x.......................x
x.......................x
x.......................x
x.......................x
xxxxxxxxxxx...xxxxxxxxxxx
