xxxxxxxxxxx...xxxxxxxxxxx
x.......................x
x.......................x
x.......................x
x.......................x
x.................000000x
x...............00000000x
..............0000.......
...........00000.........
.........00000...........
.......0000..............
x00000000...............x
x000000.................x
x.......................x
x.......................x
x.......................x
x.......................x
xxxxxxxxxxx...xxxxxxxxxxx
