xxxxxxxxxxx...xxxxxxxxxxx
x.......................x
x.......................x
x.......................x
x.......................x
x.........00000.........x
x.......................x
.........................
.........................
.........................
.........................
x.......................x
x.........00000.........x
x.......................x
x.......................x
x.......................x
x.......................x
xxxxxxxxxxx...xxxxxxxxxxx
